<s>	[silB]	silB
</s>	[silE]	silE
a	[a]	a
i	[i]	i
u	[u]	u
e	[e]	e
o	[o]	o
a:	[a:]	a:
i:	[i:]	i:
u:	[u:]	u:
e:	[e:]	e:
o:	[o:]	o:
N	[N]	N
w	[w]	w
y	[y]	y
j	[j]	j
my	[my]	my
ky	[ky]	ky
by	[by]	by
gy	[gy]	gy
ny	[ny]	ny
hy	[hy]	hy
ry	[ry]	ry
py	[py]	py
p	[p]	p
t	[t]	t
k	[k]	k
ts	[ts]	ts
ch	[ch]	ch
b	[b]	b
d	[d]	d
dy	[dy]	dy
g	[g]	g
z	[z]	z
m	[m]	m
n	[n]	n
s	[s]	s
sh	[sh]	sh
h	[h]	h
f	[f]	f
r	[r]	r
q	[q]	q
sp	[sp]	sp
